1111111111111111111
1000000001000000001
1011011101011101101
1011011101011101101
1000000000000000001
1011010111110101101
1000010001000100001
1111111111111111111
