1111111111111111111
1000000001000000001
1011011101011101101
1011011101011101101
1000000000000000001
1011010110110101101
1000010100010100001
1011010100010101101
1011010100010101101
1011010111110101101
1000000000000000001
1011011101011101101
1011011101011101101
1000000000000000001
1011010111110101101
1000010000000100001
1000000000000000001
1111111111111111111
0000000000000000000