1111111111111111111
1000000001000000001
1011011101011101101
1011011101011101101
1000000000000000001
1011010111110101101
1000010001000100001
1011111101011101101
1011111101011101101
1011111101011101101
1000000001000000001
1011011101011101101
1011011101011101101
1000000000000000001
1011010111110101101
1000010000000100001
1011111110000000001
1000000000011111111
1111111111111111111